1111111111111111111111111111111111111111111111111111111111111111111111111111111111111111111111111111
1000000001100000000110023230041000000001100233200110023230011200000001100022000110000000011000000001
1000000000000000000052000000250000000003000300300052000000252000000002002000020000000000000000000001
1000000001100000000110033230011000000001100233200110033230011000000001100022000110000000011000000001
1111001111111100111111110011111111001111111100111111110011111111001111111130111111112211111111221111
1000000001122030000112000000011000000001100303000110000000011000220001100003000110000000011000000001
1000000000000353000020000000023000000003003030300030000000030020000200222230322220000000022000000001
1000000001102030000110000000011000000001100303000110000000011000220001100003000110000000011000000001
1111001111111100111111110011111111001111111100111111113311111111001111111133111111110011111111001111
1000000001100300000110010010011000220001100000000110000000011200000001100000000110000000011003030001
1000000003300300300000003500000020000200005050500000000000002000000002000000000030000000000030303001
1000000001100000303110010010011000220001100000000110000000011000000001100000000110000000011003030001
1111001111111133111111110011111111001111111100111111110011111111001111111100111111110011111111221111
1000000001100000000110000000011300300021100000000110000000011220300001100100100112000000011000000001
1000000003000000000000505050000020002100300000000300505050000003530000000035000020000000022000000001
1000000001100000000110000000011300500031100000000110000000011020300001100100100110000000011000000001
1111331111111100111111110011111111331111111100111111110011111111301111111100111111110011111111001111
1000000001100022000110030300011000000001100000000110002200011000030001130030002110000000011000000001
1000000000002000020000303030000000000000000000000000200002002222303222002000210030000000000000000001
1111111111111111111111111111111111111111111111111111111111111111111111111111111111111111111111111111
